BB...P.PB.
P..B.B...P
...P...B.B
B......P..
BP.BBB..BB
.....P...P
PB.B.P....
P..P.B....
B.P....BBB
..B.PB.P..
#Nível 9
#POO
#10/03/2021